111111
1E00C1
110011
101101
11P1C1
111111