111111
1E10C1
110011
100101
10P0C1
111111