111111
1E00C1
110011
100101
10P1C1
111111