111111
1000C1
110011
1001E1
10P001
111111