1111111111111111111111111
11C000000000C0000000000C1
1000000000001000000000001
100011C000001100000111X01
1000111100000000C000C1001
1000000C0000C000100001001
1000010000011100100000001
1000C10000011100000010001
100000000000C00000001C001
1C01000011000000000000001
1001C00000000000011110001
100111000001100000E110001
1000000000010000000000001
1P000000000C0000000000C11
1111111111111111111111111