1111111111111111
1101011100000011
1001001000000001
1000C00001100101
10001011X1100101
11101011C0000101
1100100000011101
1000011111000001
11P0C0000000C0E1
1111111111111111
