1111111111111111111111
1E000000000000C0000001
1111010100100000101001
1010010010101010001001
100000000C00C000000001
1010010000100000101001
1010010000101000001001
1010101111100001111001
1P0C0C1001001010C00001
1111111111111111111111