1111111111111111111111111
11C0000000000000000000011
10110000000000000000011C1
1001100000000000000011001
1000100000000000000010001
1000000110000000110000001
1000000110000000110000001
1000000000000000000000001
1000000000010000000000001
1000000000000110000000001
100000000001P010000000001
1000000000011000000000001
1000000000000010000000001
1000000110000000110000001
1000000110000000110000001
1000100000000000000010001
1001100000000000000011001
1C11000000000000000001101
11X0000000000000000000E11
1111111111111111111111111