111111111111111111111111111111
110000C111000000000001000000P1
111011010111111111110111111101
1C1011010000000000000C00000101
101011010111111111111111110101
101011010000000000000000010101
101011010111111000000000010101
100000011100001011111111110101
101000000000101010000000000101
101110000011101010111111110101
100011101110001010100000000101
100010000010111010101111111101
1E0010000C10000010100000000001
111111111111111111111111111111