1111111111111111111111111
1000000C0000010000C000E11
100C1111111C000111111C001
11P000C000001000C00000001
1111111111111111111111111